##############################################################
#                            #                               #
#       X                    #                               #
#                            #                               #
#                            #                               #
#                                                            #
#                            #                               #
#                     O      #                               #
#                            #                               #
#                            #                               #
#                           #                                #
#        O                #   P                              ###################
#                       #                                    #                O#
#                      #                                     #                 #
#                     #                                      #                 #
#                    #                                       #                 #
#                   #                                                          #
#                 #                                                            #
#               #                                            #                 #
#             ################################################    X            #
#                                      #                                       #
#                                      #                                       #
#           X                          #                                       #
#                                      #    O                     X            #
#                          O           #                                       #
#           X                          #                                       #
#                                      #                                       #
#                                      #                                       #
################################################################################
